                        |.                                           .|
                        |.'                                         '.|
                        |.'',                                     ,''.|
                        |.'.'',                                 ,''.'.|
                        |.'.'.'',                             ,''.'.'.|
                        |.'.'.'.'',                         ,''.'.'.'.|
                        |.'.'.'.'.|                         |.'.'.'.'.|
                        |.'.'.'.'.|===;                 ;===|.'.'.'.'.|
                        |.'.'.'.'.|:::|',             ,'|:::|.'.'.'.'.|
                        |.'.'.'.'.|---|'.|,         ,|.'|---|.'.'.'.'.|
                        |.'.'.'.'.|:::|'.|'|       |'|.'|:::|.'.'.'.'.|
                        |,',',',',|---|',|'|       |'|,'|---|,',',',',|
                        |.'.'.'.'.|:::|'.|'|  /%\  |'|.'|:::|.'.'.'.'.|
                        |.'.'.'.'.|---|','   /%%%\   ','|---|.'.'.'.'.|
                        |.'.'.'.'.|===:'    /%%%%%\    ':===|.'.'.'.'.|
                        |.'.'.'.'.|%%%%%%%%%%%%%%%%%%%%%%%%%|.'.'.'.'.|
                        |.'.'.'.','       /%%%%%%%%%\       ','.'.'.'.|
                        |.'.'.','        /%%%%%%%%%%%\        ','.'.'.|
                        |.'.','         /%%%%%%%%%%%%%\         ','.'.|
                        |.','          /%%%%%%%%%%%%%%%\          ','.|
                        |;____________/%%%%%%%%%%%%%%%%%\____________;|