|.'',                                     ,''.|
|.'.'',                                 ,''.'.|
|.'.'.'',                             ,''.'.'.|
|.'.'.'.'',                         ,''.'.'.'.|
|.'.'.'.'.|                         |.'.'.'.'.|
|.'.'.'.'.|===;.'.'.'.'.'.'.'.'.;===|.'.'.'.'.|
|.'.'.'.'.|:::|.'.'.'.'.'.'.'.'.|:::|.'.'.'.'.|
|.'.'.'.'.|---|.'.'.'.'.'.'.'.'.|---|.'.'.'.'.|
|.'.'.'.'.|:::|.'.'.'.'.'.'.'.'.|:::|.'.'.'.'.|
|,',',',',|---|.'.'.'.'.'.'.'.'.|---|,',',',',|
|.'.'.'.'.|:::|.'.'.'.'.'.'.'.'.|:::|.'.'.'.'.|
|.'.'.'.'.|---|.'.'.'.'.'.'.'.'.|---|.'.'.'.'.|
|.'.'.'.'.|===:.'.'.'.'.'.'.'.'.:===|.'.'.'.'.|
|.'.'.'.'.|%%%%%%%%%%%%%%%%%%%%%%%%%|.'.'.'.'.|
|.'.'.'.','       /%%%%%%%%%\       ','.'.'.'.|
|.'.'.','        /%%%%%%%%%%%\        ','.'.'.|
|.'.','         /%%%%%%%%%%%%%\         ','.'.|
|.','          /%%%%%%%%%%%%%%%\          ','.|
|;____________/%%%%%%%%%%%%%%%%%\____________;|