|.'',                                     ,''.|
|.'.'',                                 ,''.'.|
|.'.'.'',                             ,''.'.'.|
|.'.'.'.'',                         ,''.'.'.'.|
|.'.'.'.'.|',                     ,'|.'.'.'.'.|
|.'.'.'.'.|'.';                 ;'.'|.'.'.'.'.|
|.'.'.'.'.|'.'|',             ,'|'.'|.'.'.'.'.|
|.'.'.'.'.|'.'|'.|,         ,|.'|'.'|.'.'.'.'.|
|.'.'.'.'.|'.'|'.|'|       |'|.'|'.'|.'.'.'.'.|
|,',',',',|','|',|'|       |'|,'|','|,',',',',|
|.'.'.'.'.|'.''.|'.|  /%\  |'|.'|'.'|.'.'.'.'.|
|.'.'.'.'.|'.'|','   /%%%\   ','|'.'|.'.'.'.'.|
|.'.'.'.'.|'.,:'    /%%%%%\    ':,.'|.'.'.'.'.|
|.'.'.'.'.|,'      /%%%%%%%\      ',|.'.'.'.'.|
|.'.'.'.','       /%%%%%%%%%\       ','.'.'.'.|
|.'.'.','        /%%%%%%%%%%%\        ','.'.'.|
|.'.','         /%%%%%%%%%%%%%\         ','.'.|
|.','          /%%%%%%%%%%%%%%%\          ','.|
|;____________/%%%%%%%%%%%%%%%%%\____________;|